이 냄새는 시간이 좀 지나면 없어질 것입니다.	This aroma may dissipate after a short period of time.
벌써 세 번째 나오는데 처음인게 신기하네요.	It's unbelievable that it's our first, given that we have done 3 releases.
새 위원회가 이번 주에 첫 총회를 개최한다.	The new committee holds its first plenary session this week.
그렇게 해도 그는 무례가 되지 않는다.	It is no discourtesy with him to do so.  
그들은 허심탄회한 대화를 나누었다 	They talked candidly with each other.  
교육 문제를 두고 심각한 의견 대립이 발생했다.	A row has broken out over education.  
정말 기대하면서 손꼽았던!	It's the highly anticipated and eagerly awaited!   
그 로프는 2∼3미터로 너무 짧다.	The rope was a couple of meters too short.  
모스크바에 도착하려면 앞으로 4일 걸리는 길입니다.	You've got another four days' journey before you reach Moscow.   
그들은 결국 최초의 계획을 고집하기로 결정하였다.	They have decided to stick to the original plan after all.  
그 회의는 3월에 열릴 예정이었는데 4월로 연기되었다.	The conference was scheduled for March, but it has been put off till April.
내일은 약속이 있습니다. 그래서 나를 대리해 줄 사람을 수배해 놓았습니다.	I'm engaged tomorrow, so I've arranged for someone else to take my place.
그의 음악적 재능은 아버지한테서 물려받았다.	He inherited his talent for music from his father. 
그 어린애들은 즉시 사방 팔방으로 도망갔다.	The children immediately ran away in all directions. 
그녀의 갑작스런 죽음은 국가 전체를 큰 충격에 빠뜨렸다.	Her sudden death dealt a blow to the whole country. 
그것은 그 나라의 이미지에 심각한 영향을 줄 것이다.	It would deal a serious blow to the image of the country.
그는 여섯 줄에 여섯 번이나 그 단어를 사용했다	He used the word half-a-dozen times in as many lines.  
핼리 혜성은 80년마다 한번 찾아온다.	Halley's Comet comes around once every eighty years. 
미리 전화를 해서 테이블을 예약해 두었어야 했는데.	We ought to have phoned ahead and reserved a table.  
그이를 어디선가 본일이 있는 것 같다.	It is likely that I saw him some-where before.
당신은 철자와 구두점에 좀더 주의해야 한다.	You must be more careful about spelling and punctuation. 
그 종기로 판단하면 그 사람은 뱀에 물린 것이 틀림이 없습니다.	Judging by the swelling, the man must have been bitten by a snake.
그 증거에는 의심의 여지가 없다. 이것이 피카소의 진짜 작품일 수가 없다.	The evidence leaves no room for doubt; this can't be an original Picasso.
그의 투수로서 능력을 부정할 수 없지만 꽤 부상에 약하다.	There's no denying his ability as a pitcher, but he is rather injury-prone.
이 창문이 아무리 해도 열리지 않아요. 움직일 수 있을지 어떨지 어떻게 해 보세요.	This window won't open. See if you can get it to move.  
오늘날 남자들이 담배를 훨씬 더 적게 피운다는 사실이 한국 담배 산업계의 고민거리다.	The fact that nowadays fewer men smoke is a headache  for the Korean tobacco industry.
그녀를 몹시 보고 싶지만 시간이 없다.	I want very much to see her, but I have no spare time.   
그녀는 그날 있었던 일에 대한 자신의 생각을 우리에게 들려주었다.	She gave us her version of what had happened that day.
우리는 외환 위기라는 풍랑을 잘 헤쳐 나왔다	We managed to weather the storm of the Asian financial crisis well.
여기 책상에 있는 것들 아무것도 버리지 마. 나중에 집에 오면 내가 모두 다 정리할께	Don't throw away anything on this desk. I will organize everything when I get back home later.
난 그거 필요없어. 버려도 돼.	I don't need that - you can throw it away.
축구팀이 네 시합을 연달아 이겼다.	The soccer team won four games in a row.
성공적인 행사 진행을 위해 우리는 만반의 준비를 갖추었다.	For successful event progress, we got our ducks in a row.   
그 주제에 대한 세계 최고 권위자	the world’s foremost authority on the subject  
그는 궁지에 빠져버렸다.	He has been in great straits.
나는 찬장을 당신의 임의처분에 맡기겠습니다.	I will leave the cupboard at your disposal. 
응원을 너무 했더니 목이 쉰 것 같아. 	I think I'm getting hoarse from all this cheering.
목소리가 쉰 것 같네. 약이라도 먹었나?	You sound hoarse today. Have you taken anything for it?
그의 이마에 땀방울이 송골송골 맺혀 있었다.	Beads of perspiration stood out on his forehead.
그녀의 피부는 땀에 젖어 축축했다.	Her skin was damp with perspiration.
나는 환절기에 감기에 잘 걸린다.	I'm susceptible to colds, when the weather changes. 
우리는 결단력 있고 확고한 지도력이 필요하다.   	We need a decisive and unwavering leadership.
넌 루시에게 첫눈에 반한 것 같았어.	You seemed to have a crush on Lucy at first sight.
저 음식점은 고급요리만 판다.	That restaurant serves only haute cuisine.
볼드윈 씨는 고급 요식업계에 손을 대고 있습니다.	Mr. Baldwin is dabbling in the world of haute cuisine.
정찬에는 정장하는 것이 관례였다.	It was customary to dress for dinner.
그는 평소처럼 오만하게 첫날 회의를 주재했다. 	He presided at/over the first day of the meeting with his customary hauteur.
일요일에 일을 해야 한다면 그것은 정말 순리에 어긋나는 일이다.	It really goes against the grain to have to work on a Sunday.
그는 약을 단숨에 삼켰어요.	He downed his medicine in one gulp.
꿀꺽 삼키면 맛을 즐기지 못한다.	If you gulp it down, you can't enjoy the taste.
그는 나에게 자활(自活)의 길을 터주었다.	He put me into the way of obtaining my own livelihood.
그 억울함이 그의 마음에 사무쳤다.	The resentment festered in his mind.
그의 목소리에는 분노가 서려있었다.	There was a note of resentment in his voice.
이 원한은 두고두고 잊지 않겠다	I shall carry the resentment to the grave.
그녀는 나를 원망스러운 눈으로 쳐다보았다	She looked at me with resentment in her eyes.
그녀는 아직도 억울해서 속이 부글부글 끓었다.	She was still simmering with resentment.
그래서 그게 한이 됐었거든요.	So, I was filled with resentment.
